5 5 1 1
1 1 1 1 4
1 2 1 1 1
1 1 1 1 4
0 0 0 1 1
1 4 1 0 4

10 10 5 5
1 1 1 1 4 1 1 1 1 1
1 0 0 1 1 1 0 0 1 1
1 0 4 0 1 1 0 4 0 1
1 1 1 1 2 1 1 1 1 1
4 1 1 1 1 1 1 1 1 4
1 1 0 0 1 2 0 0 1 1
1 0 4 0 1 1 0 4 0 1
1 1 1 1 1 1 1 1 1 1
1 0 0 1 3 1 1 0 0 1
1 1 1 1 4 1 1 1 1 1